Brand

scion = "Scion"
saab = "Saab"
lexus = "Lexus"
rivian = "Rivian"
mini = "MINI"
alfa = "Alfa"
land = "Land"
infiniti = "INFINITI"
rolls_royce = "Rolls-Royce"
cadillac = "Cadillac"
nissan = "Nissan"
toyota = "Toyota"
mclaren = "McLaren"
ferrari = "Ferrari"
karma = "Karma"
hyundai = "Hyundai"
suzuki = "Suzuki"
chrysler = "Chrysler"
porsche = "Porsche"
jaguar = "Jaguar"
kia = "Kia"
buick = "Buick"
bentley = "Bentley"
tesla = "Tesla"
ford = "Ford"
maserati = "Maserati"
pontiac = "Pontiac"
subaru = "Subaru"
polestar = "Polestar"
jeep = "Jeep"
mercedes_benz = "Mercedes-Benz"
chevrolet = "Chevrolet"
maybach = "Maybach"
lamborghini = "Lamborghini"
smart = "smart"
bugatti = "Bugatti"
plymouth = "Plymouth"
lucid = "Lucid"
mercury = "Mercury"
aston = "Aston"
fiat = "FIAT"
genesis = "Genesis"
mazda = "Mazda"
mitsubishi = "Mitsubishi"
lincoln = "Lincoln"
gmc = "GMC"
dodge = "Dodge"
saturn = "Saturn"
hummer = "Hummer"
bmw = "BMW"
audi = "Audi"
volvo = "Volvo"
acura = "Acura"
volkswagen = "Volkswagen"
lotus = "Lotus"
ram = "RAM"
honda = "Honda"

Fuel_type

hybrid = "Hybrid"
electric = "Electric"
e85_flex_fuel = "E85 Flex Fuel"
diesel = "Diesel"
plug_in_hybrid = "Plug-In Hybrid"
gasoline = "Gasoline"

Transmission

automatic = "Automatic"
manual = "Manual"

Accident

at_least_1_accident_or_damage_reported = "At least 1 accident or damage reported"
none_reported = "None reported"

Clean_title

yes = "Yes"
no = "No"

